###############
#.............#
#.............#
#......E......#
#.............#
#.....##......#
#.............#
#......P......#
#.............#
#..........E..#
#.......E.....#
#.............#
#.............#
#.............#
###############